----------------------------------------------------------------------------------------------------------------------------------------------------------------------------------------------------------------------------------------------------------------
----------------------------------------------------------------------------------------------------------------------------------------------------------------------------------------------------------------------------------------------------------------
----------------------------------------------------------------------------------------------------------------------------------------------------------------------------------------------------------------------------------------------------------------
----------------------------------------------------------------------------------------------------------------------------------------------------------------------------------------------------------------------------------------------------------------
-------------------------------------------------------------------------------------------------------------------------------------------------------------------------------------------------------SS-------------------------------------------------------
--------------------------------------------------------------------------------------------------------------------------------------------------------------------------------------------------#-------------------------------------------------------------
---------------------------------------------------------------------------------------------------------------------------------------------------------------------------------------------#----#-------------------------------------------------------------
----------------------------------------------------------------------------------------------------------------------------------------------------------------------------------------#----#----#-------------------------------------------------------------
---------------------------------------------------------------------------------------------------------------------------------SSSS-----SSSS-----SSSS----------------------------#----#----#------------------------------------------------------------------
---------------------------------------------------------#-----#-----#--------------------------------------------#-----#-----#-----------------------------------------------#----#----#-------------#############---------------------------------------------
---------------------------------------------------------s-----s-----s--------------------------------------------s-----s-----s------------------------------------------#----#----#----------------------------------------------------------------------------
---------------------------------------------------------------------------------------------#-----------------------------------####-----####-----####-------------#----#----#---------------------------------------------------------------------------------
----------------------------------------------------------------------------------------#----#-------------------------------------------------------------------sSS#----#--------------------------------------------------------------------------------------
-P-------------------------------------------------------s-----s-----s-------------#----#----#--------------------#-----#-----#--------#--------#--------############-------------------------------------------------------------------------------------------
--------------------------------sS----sS----sS-----------#-----#-----#----------sSS#SSSS#SSSS#------sS---sS-----------------------------------------------------------------------------------------------------------------------------------------------------
##############################################################################################----#############------------------####-----####-----####---------------------------------------------------------------------------------------------------------
